whippoorwill	an american bird antrostomus vociferus allied to the nighthawk and goatsucker  so called in imitation of the peculiar notes which it utters in the evening
arm	the limb of the human body which extends from the shoulder to the hand also the corresponding limb of a monkey
allegorizer	one who allegorizes or turns things into allegory an allegorist
internment	confinement within narrow limits  as of foreign troops to the interior of a country
hypospadias	a deformity of the penis in which the urethra opens upon its under surface
phytochemistry	chemistry in its relation to vegetable bodies vegetable chemistry
nasutness	quickness of scent hence nice discernment acuteness
vitrifaction	the act art or process of vitrifying also the state of being vitrified
transplantation	the act of transplanting or the state of being transplanted also removal
delusion	the act of deluding deception a misleading of the mind
matachin	an old dance with swords and bucklers a sword dance
clemency	disposition to forgive and spare as offenders mildness of temper gentleness tenderness mercy
cucurbite	a vessel or flask for distillation used with or forming part of an alembic a matrass  originally in the shape of a gourd with a wide mouth see alembic
salse	a mud volcano the water of which is often impregnated with salts whence the name
bungalow	a thatched or tiled house or cottage of a single story usually surrounded by a veranda
porphyrization	the act of porphyrizing or the state of being porphyrized
pique	a cotton fabric figured in the loom  used as a dress goods for women and children and for vestings etc
lansquenet	a german foot soldier in foreign service in the th and th centuries a soldier of fortune  a term used in france and western europe
aestheticism	the doctrine of aesthetics aesthetic principles devotion to the beautiful in nature and art
flyspeck	a speck or stain made by the excrement of a fly hence any insignificant dot
incogitancy	want of thought or of the power of thinking thoughtlessness unreasonableness
pewee	a common american tyrant flycatcher sayornis phoebe or s fuscus called also pewit and phoebe
nonconformist	one who does not conform to an established church especially one who does not conform to the established church of england a dissenter
preacher	one who preaches one who discourses publicly on religious subjects
longbeak	the american redbellied snipe macrorhamphus scolopaceus  called also longbilled dowitcher
dyeing	the process or art of fixing coloring matters permanently and uniformly in the fibers of wool cotton etc
subtleness	the quality or state of being subtle subtlety
circumnavigation	the act of circumnavigating or sailing round
sketchiness	the quality or state of being sketchy lack of finish incompleteness
calking	the act or process of making seems tight as in ships or of furnishing with calks as a shoe or copying as a drawing
garnishee	one who is garnished a person upon whom garnishment has been served in a suit by a creditor against a debtor such person holding property belonging to the debtor or owing him money
stilpnomelane	a black or greenish black mineral occurring in foliated flates also in velvety bronzecolored incrustations it is a hydrous silicate of iron and alumina
rotche	a very small arctic sea bird mergulus alle or alle alle common on both coasts of the atlantic in winter  called also little auk dovekie rotch rotchie and sea dove
outline	the line which marks the outer limits of an object or figure the exterior line or edge contour
contusion	the act or process of beating bruising or pounding the state of being beaten or bruised
rete	a net or network a plexus particularly a network of blood vessels or nerves or a part resembling a network
bridle	the head gear with which a horse is governed and restrained consisting of a headstall a bit and reins with other appendages
humbleness	the quality of being humble humility meekness
universology	the science of the universe and the relations which it involves
celadon	a pale seagreen color also porcelain or fine pottery of this tint
hogchain	a chain or tie rod in a boat or barge to prevent the vessel from hogging
beginner	one who begins or originates anything specifically a young or inexperienced practitioner or student a tyro
bonesetter	one who sets broken or dislocated bones  commonly applied to one not a regular surgeon who makes an occupation of setting bones
centrum	the body or axis of a vertebra see vertebra
abnormality	the state or quality of being abnormal variation irregularity
snipe	any one of numerous species of limicoline game birds of the family scolopacidae having a long slender nearly straight beak
mycelium	the white threads or filamentous growth from which a mushroom or fungus is developed the socalled mushroom spawn
disfurniture	the act of disfurnishing or the state of being disfurnished
envier	one who envies one who desires inordinately what another possesses
landtag	the diet or legislative body as the landtag of prussia
hornwort	an aquatic plant ceratophyllum with finely divided leaves
polybromide	a bromide containing more than one atom of bromine in the molecule
propenyl	a hypothetical hydrocarbon radical ch isomeric with allyl and glyceryl and regarded as the essential residue of glycerin cf allyl and glyceryl
punk	wood so decayed as to be dry crumbly and useful for tinder touchwood
capper	one whose business is to make or sell caps
restiness	the quality or state of being resty sluggishness
dehydration	the act or process of freeing from water also the condition of a body from which the water has been removed
scrode	a young codfish especially when cut open on the back and dressed
ditheist	one who holds the doctrine of ditheism a dualist
delimitation	the act or process of fixing limits or boundaries limitation
benzamide	a transparent crystalline substance chconh obtained by the action of ammonia upon chloride of benzoyl as also by several other reactions with benzoyl compounds
chemisette	an undergarment worn by women usually covering the neck shoulders and breast
cora	the arabian gazelle gazella arabica found from persia to north africa
tender	one who tends one who takes care of any person or thing a nurse
exploration	the act of exploring penetrating or ranging over for purposes of discovery especially of geographical discovery examination as the exploration of unknown countries
beerhouse	a house where malt liquors are sold an alehouse
enjoyment	the condition of enjoying anything pleasure or satisfaction as in the possession or occupancy of anything possession and use as the enjoyment of an estate
furfurol	a colorless oily liquid chocho of a pleasant odor obtained by the distillation of bran sugar etc and regarded as an aldehyde derivative of furfuran  called also furfural
phlogistian	a believer in the existence of phlogiston
phenomenon	an appearance anything visible whatever in matter or spirit is apparent to or is apprehended by observation as the phenomena of heat light or electricity phenomena of imagination or memory
cesspool	a cistern in the course or the termination of a drain to collect sedimentary or superfluous matter a privy vault any receptacle of filth
arendator	in some provinces of russia one who farms the rents or revenues
traditionalist	an advocate of or believer in traditionalism a traditionist
tucket	a slight flourish on a trumpet a fanfare
steel	to overlay point or edge with steel as to steel a razor to steel an ax
mistura	a mingled compound in which different ingredients are contained in a liquid state a mixture see mixture n
epiphora	the watery eye a disease in which the tears accumulate in the eye and trickle over the cheek
pestle	an implement for pounding and breaking or braying substances in a mortar
dicast	a functionary in ancient athens answering nearly to the modern juryman
cerebrology	the science which treats of the cerebrum or brain
spiroscope	a wet meter used to determine the breathing capacity of the lungs
grist	ground corn that which is ground at one time as much grain as is carried to the mill at one time or the meal it produces
abnet	the girdle of a jewish priest or officer
ictus	the stress of voice laid upon accented syllable of a word cf arsis
ravehook	a tool hooked at the end for enlarging or clearing seams for the reception of oakum
caloyer	a monk of the greek church a cenobite anchoret or recluse of the rule of st basil especially one on or near mt athos
fanon	a term applied to various articles as a a peculiar striped scarf worn by the pope at mass and by eastern bishops b a maniple
sandbagger	an assaulter whose weapon is a sand bag see sand bag under sand
negotiosity	the state of being busy multitude of business
donee	the person to whom a gift or donation is made
tanglefish	the sea adder or great pipefish of europe
synchysis	a derangement or confusion of any kind as of words in a sentence or of humors in the eye
contrabasso	the largest kind of bass viol see violone
raglan	a loose overcoat with large sleeves  named from lord raglan an english general
pathfinder	one who discovers a way or path one who explores untraversed regions
baal	the supreme male divinity of the phoenician and canaanitish nations
frustum	the part of a solid next the base formed by cutting off the top or the part of any solid as of a cone pyramid etc between two planes which may be either parallel or inclined to each other
superfamily	a group intermediate between a family and a suborder
regress	the act of passing back passage back return retrogression the progress or regress of man
currentness	the quality of being current currency circulation general reception
index	that which points out that which shows indicates manifests or discloses
abiogenist	one who believes that life can be produced independently of antecedent
aerator	that which supplies with air esp an apparatus used for charging mineral waters with gas and in making soda water
focimeter	an assisting instrument for focusing an object in or before a camera
equisonance	an equal sounding the consonance of the unison and its octaves
proboscis	a hollow organ or tube attached to the head or connected with the mouth of various animals and generally used in taking food or drink a snout a trunk
rubble	waterworn or rough broken stones broken bricks etc used in coarse masonry or to fill up between the facing courses of walls
achatina	a genus of land snails often large common in the warm parts of america and africa
nucula	a genus of small marine bivalve shells having a pearly interior
heirdom	the state of an heir succession by inheritance
coussinet	a stone placed on the impost of a pier for receiving the first stone of an arch
chloranil	a yellow crystalline substance cclo regarded as a derivative of quinone obtained by the action of chlorine on certain benzene derivatives as aniline
dyad	two units treated as one a couple a pair
arming	the act of furnishing with or taking arms
bitterweed	a species of ambrosia a artemisiaefolia roman worm wood
resume	a summing up a condensed statement an abridgment or brief recapitulation
metempirics	the concepts and relations which are conceived as beyond and yet as related to the knowledge gained by experience
authenticness	the quality of being authentic authenticity
norimon	a japanese covered litter carried by men
seafarer	one who follows the sea as a business a mariner a sailor
doge	the chief magistrate in the republics of venice and genoa
boer	a colonist or farmer in south africa of dutch descent
deloul	a special breed of the dromedary used for rapid traveling the swift camel  called also herire and maharik
polythelism	the condition of having more than two teats or nipples
roommate	one of twe or more occupying the same room or rooms one who shares the occupancy of a room or rooms a chum
instability	the quality or condition of being unstable want of stability firmness or steadiness liability to give way or to fail insecurity precariousness as the instability of a building
clientele	the condition or position of a client clientship
croylstone	crystallized cawk in which the crystals are small
argosy	a large ship esp a merchant vessel of the largest size
saros	a chaldean astronomical period or cycle the length of which has been variously estimated from  years to  days or a little short of  years
childbearing	the act of producing or bringing forth children parturition
verbalist	a literal adherent to or a minute critic of words a literalist
natchnee	an annual grass eleusine coracona cultivated in india as a food plant
gutwort	a plant globularia alypum a violent purgative found in africa
interdict	to forbid to prohibit or debar as to interdict intercourse with foreign nations
mineralization	the process of mineralizing or forming a mineral by combination of a metal with another element also the process of converting into a mineral as a bone or a plant
myxopod	a rhizopod or moneran also used adjectively as a myxopod state
aepyornis	a gigantic bird found fossil in madagascar
hyperaesthesia	a state of exalted or morbidly increased sensibility of the body or of a part of it
cordwainer	a worker in cordwain or cordovan leather a shoemaker
sculptor	one who sculptures one whose occupation is to carve statues or works of sculpture
excitability	the quality of being readily excited proneness to be affected by exciting causes
pastern	the part of the foot of the horse and allied animals between the fetlock and the coffin joint see illust of horse
dispoline	one of several isomeric organic bases of the quinoline series of alkaloids
pressiroster	one of a tribe of wading birds pressirostres including those which have a compressed beak as the plovers
dolium	a genus of large univalve mollusks including the partridge shell and tun shells
hobbist	one who accepts the doctrines of thomas hobbes
hyalea	a pteroid of the genus cavolina see pteropoda and illustration in appendix
vehicle	that in or on which any person or thing is or may be carried as a coach carriage wagon cart car sleigh bicycle etc a means of conveyance specifically a means of conveyance upon land
mutule	a projecting block worked under the corona of the doric corice in the same situation as the modillion of the corinthian and composite orders see illust of gutta
reefer	one who reefs  a name often given to midshipmen
saker	a falcon falco sacer native of southern europe and asia closely resembling the lanner
gwiniad	a fish coregonus ferus of north wales and northern europe allied to the lake whitefish  called also powan and schelly
inrecision	a cutting off through or asunder interruption
fermerere	the officer in a religious house who had the care of the infirmary
telescope	an optical instrument used in viewing distant objects as the heavenly bodies
agami	a south american bird psophia crepitans allied to the cranes and easily domesticated  called also the goldbreasted trumpeter its body is about the size of the pheasant see trumpeter
dust	fine dry particles of earth or other matter so comminuted that they may be raised and wafted by the wind that which is crumbled too minute portions fine powder as clouds of dust bone dust
unambiguity	absence of ambiguity clearness perspicuity
vivarium	a place artificially arranged for keeping or raising living animals as a park a pond an aquarium a warren etc
alidade	the portion of a graduated instrument as a quadrant or astrolabe carrying the sights or telescope and showing the degrees cut off on the arc of the instrument
trayful	as much as a tray will hold enough to fill a tray
bywash	the outlet from a dam or reservoir also a cut to divert the flow of water
piacle	a heinous offense which requires expiation
sinigrin	a glucoside found in the seeds of black mustard brassica nigra formerly sinapis nigra it resembles sinalbin and consists of a potassium salt of myronic acid
houndstongue	a biennial weed cynoglossum officinale with soft tongueshaped leaves and an offensive odor it bears nutlets covered with barbed or hooked prickles called also dogstongue
exaggerator	one who exaggerates one addicted to exaggeration
detecter	one who or that which detects or brings to light one who finds out what another attempts to conceal a detector
catstick	a stick or club employed in the game of ball called cat or tipcat
quahaug	an american market clam venus mercenaria it is sold in large quantities and is highly valued as food called also round clam and hard clam
pursuivant	a functionary of lower rank than a herald but discharging similar duties  called also pursuivant at arms an attendant of the heralds also used figuratively
pookoo	a red african antelope kobus vardoni allied to the water buck
simpleness	the quality or state of being simple simplicity
performance	the act of performing the carrying into execution or action execution achievement accomplishment representation by action as the performance of an undertaking of a duty
hearing	the act or power of perceiving sound perception of sound the faculty or sense by which sound is perceived as my hearing is good
drawknife	a joiners tool having a blade with a handle at each end used to shave off surfaces by drawing it toward one a shave  called also drawshave and drawing shave
sightseer	one given to seeing sights or noted things or eager for novelties or curiosities
threadworm	any long slender nematode worm especially the pinworm and filaria
nugget	a lump a mass esp a native lump of a precious metal as a nugget of gold
somnambulist	a person who is subject to somnambulism one who walks in his sleep a sleepwalker a noctambulist
priestism	the influence doctrines principles etc of priests or the priesthood
spoke	the radius or ray of a wheel one of the small bars which are inserted in the hub or nave and which serve to support the rim or felly
afterthought	reflection after an act later or subsequent thought or expedient
anointment	the act of anointing or state of being anointed also an ointment
bantam	a variety of small barnyard fowl with feathered legs probably brought from bantam a district of java
atlanta	a genus of small glassy heteropod mollusks found swimming at the surface in mid ocean see heteropod
vineyard	an inclosure or yard for grapevines a plantation of vines producing grapes
bedesman	a poor man supported in a beadhouse and required to pray for the soul of its founder an almsman
erythrochroism	an unusual redness esp in the plumage of birds or hair of mammals independently of age sex or season
incorporealism	existence without a body or material form immateriality
solfatara	a volcanic area or vent which yields only sulphur vapors steam and the like it represents the stages of the volcanic activity
scirrhosity	a morbid induration as of a gland state of being scirrhous
scurviness	the quality or state of being scurvy vileness meanness
archaeopteryx	a fossil bird of the jurassic period remarkable for having a long tapering tail of many vertebrae with feathers along each side and jaws armed with teeth with other reptilian characteristics
lysimeter	an instrument for measuring the water that percolates through a certain depth of soil
cranage	the liberty of using a crane as for loading and unloading vessels
thirdpenny	a third part of the profits of fines and penalties imposed at the country court which was among the perquisites enjoyed by the earl
pigwidgeon	a cant word for anything petty or small it is used by drayton as the name of a fairy
exophthalmia	the protrusion of the eyeball so that the eyelids will not cover it in consequence of disease
karmathian	one of a mohammedan sect founded in the ninth century by karmat
kraal	a collection of huts within a stockade a village sometimes a single hut
affluence	a flowing to or towards a concourse an influx
rytina	a genus of large edentulous sirenians allied to the dugong and manatee including but one species r stelleri  called also stellers sea cow
scripture	anything written a writing a document an inscription
norther	a wind from the north esp a strong and cold north wind in texas and the vicinity of the gulf of mexico
tenderling	one made tender by too much kindness a fondling
viewiness	the quality or state of being viewy or of having unpractical views
barytes	barium sulphate generally called heavy spar or barite see barite
arsine	a compound of arsenic and hydrogen ash a colorless and exceedingly poisonous gas having an odor like garlic arseniureted hydrogen
splanchnology	that part of anatomy which treats of the viscera also a treatise on the viscera
sardius	a precious stone probably a carnelian one of which was set in aarons breastplate
garner	a granary a building or place where grain is stored for preservation
synomocy	sworn brotherhood a society in ancient greece nearly resembling a modern political club
verticil	a circle either of leaves or flowers about a stem at the same node a whorl
prow	the fore part of a vessel the bow the stem hence the vessel itself
gad	to walk about to rove or go about without purpose hence to run wild to be uncontrolled
shadbird	the american or wilsons snipe see under snipe so called because it appears at the same time as the shad
saussurite	a tough compact mineral of a white greenish or grayish color it is near zoisite in composition and in part at least has been produced by the alteration of feldspar
judahite	one of the tribe of judah a member of the kingdom of judah a jew
pupa	any insect in that stage of its metamorphosis which usually immediately precedes the adult or imago stage
jackadandy	a little dandy a little foppish impertinent fellow
daybreak	the time of the first appearance of light in the morning
tangerine	a kind of orange much like the mandarin but of deeper color and higher flavor it is said to have been produced in america from the mandarin
obstruction	the act of obstructing or state of being obstructed
valetudinarianism	the condition of a valetudinarian a state of feeble health infirmity
peziza	a genus of fungi embracing a great number of species some of which are remarkable for their regular cuplike form and deep colors
giggyng	the act of fastending the gige or leather strap to the shield
distributer	one who or that which distributes or deals out anything a dispenser
guinea	a district on the west coast of africa formerly noted for its export of gold and slaves after which the guinea fowl guinea grass guinea peach etc are named
transanimation	the conveyance of a soul from one body to another
sonifer	a kind of ear trumpet for the deaf or the partially deaf
superreflection	the reflection of a reflected image or sound
chiliarch	the commander or chief of a thousand men
alburn	the bleak a small european fish having scales of a peculiarly silvery color which are used in making artificial pearls
decantation	the act of pouring off a clear liquor gently from its lees or sediment or from one vessel into another
rowboat	a boat designed to be propelled by oars instead of sails
mumchance	a game of hazard played with cards in silence
tinto	a red madeira wine wanting the high aroma of the white sorts and when old resembling tawny port
narration	the act of telling or relating the particulars of an event rehearsal recital
nectocalyx	the swimming bell or umbrella of a jellyfish of medusa
selflove	the love of ones self desire of personal happiness tendency to seek ones own benefit or advantage
infinity	unlimited extent of time space or quantity eternity boundlessness immensity
lagging	the clothing esp an outer wooden covering as of a steam cylinder applied to prevent the radiation of heat a covering of lags  called also deading and cleading
apex	the tip top point or angular summit of anything as the apex of a mountain spire or cone the apex or tip of a leaf
fellmonger	a dealer in fells or sheepskins who separates the wool from the pelts
guttatrap	the inspissated juice of a tree of the genus artocarpus a incisa or breadfruit tree sometimes used in making birdlime on account of its glutinous quality
kidderminster	a kind of ingrain carpeting named from the english town where formerly most of it was manufactured
expressness	the state or quality of being express definiteness
chicken	a young bird or fowl esp a young barnyard fowl
compacture	close union or connection of parts manner of joining construction
oleate	a salt of oleic acid some oleates as the oleate of mercury are used in medicine by way of inunction
redundancy	the quality or state of being redundant superfluity superabundance excess
moraine	an accumulation of earth and stones carried forward and deposited by a glacier
xanthoxylum	a genus of prickly shrubs or small trees the bark and rots of which are of a deep yellow color prickly ash
predilection	a previous liking a prepossession of mind in favor of something predisposition to choose or like partiality
beauty	an assemblage or graces or properties pleasing to the eye the ear the intellect the aesthetic faculty or the moral sense
animadverter	one who animadverts a censurer also obs a chastiser
neckwear	a collective term for cravats collars etc
eudiometry	the art or process of determining the constituents of a gaseous mixture by means of the eudiometer or for ascertaining the purity of the air or the amount of oxygen in it
indistinction	want of distinction or distinguishableness confusion uncertainty indiscrimination
tharos	a small american butterfly phycoides tharos having the upper surface of the wings variegated with orange and black the outer margins black with small white crescents  called also pearl crescent
bachelorism	bachelorhood also a manner or peculiarity belonging to bachelors
puberty	the earliest age at which persons are capable of begetting or bearing children usually considered in temperate climates to be about fourteen years in males and twelve in females
nonfeasance	an omission or neglect to do something esp that which ought to have been done cf malfeasance
haugh	a lowlying meadow by the side of a river
dingle	a narrow dale a small dell a small secluded and embowered valley
identity	the state or quality of being identical or the same sameness
junkerism	the principles of the aristocratic party in prussia
parochialism	the quality or state of being parochial in form or nature a system of management peculiar to parishes
misconception	erroneous conception false opinion wrong understanding
intercalation	the insertion of a day or other portion of time in a calendar
pruner	one who prunes or removes what is superfluous
lithophyse	a spherulitic cavity often with concentric chambers observed in some volcanic rocks as in rhyolitic lavas it is supposed to be produced by expanding gas whence the name
agistment	formerly the taking and feeding of other mens cattle in the kings forests
basyle	a positive or nonacid constituent of compound either elementary or if compound performing the functions of an element
antichristianity	opposition or contrariety to the christian religion
strid	a narrow passage between precipitous rocks or banks which looks as if it might be crossed at a stride
crappie	a kind of freshwater bass of the genus pomoxys found in the rivers of the southern united states and mississippi valley there are several species
accipiter	a genus of rapacious birds one of the accipitres or raptores
xylamide	an acid amide derivative of xylic acid obtained as a white crystalline substance
obligee	the person to whom another is bound or the person to whom a bond is given
krooman	one of a negro tribe of liberia and the adjacent coast whose members are much employed on shipboard
distich	a couple of verses or poetic lines making complete sense an epigram of two verses
bedplate	the foundation framing or piece by which the other parts are supported and held in place the bed  called also baseplate and soleplate
substyle	a right line on which the style or gnomon of a dial is erected being the common section of the face of the dial and a plane perpendicular to it passing through the style
figeater	a large beetle allorhina nitida which in the southern united states destroys figs the elytra are velvety green with pale borders
trivium	the three  liberal arts grammar logic and rhetoric  being a triple way as it were to eloquence
cenanthy	the absence or suppression of the essential organs stamens and pistil in a flower
stackstand	a staging for supporting a stack of hay or grain a rickstand
piassava	a fibrous product of two brazilian palm trees attalea funifera and leopoldinia piassaba  used in making brooms and for other purposes called also piacaba and piasaba
liparian	any species of a family liparidae of destructive bombycid moths as the tussock moths
lump	a small mass of matter of irregular shape an irregular or shapeless mass as a lump of coal a lump of iron ore
lyra	a northern constellation the harp containing a white star of the first magnitude called alpha lyrae or vega
meleagris	a genus of american gallinaceous birds including the common and the wild turkeys
assistance	the act of assisting help aid furtherance succor support
primitiveness	the quality or state of being primitive conformity to primitive style or practice
longsuffering	bearing injuries or provocation for a long time patient not easily provoked
enthrallment	the act of enthralling or state of being enthralled see inthrallment
quartzite	massive quartz occurring as a rock a metamorphosed sandstone  called also quartz rock
earthiness	the quality or state of being earthy or of containing earth hence grossness
archon	one of the chief magistrates in ancient athens especially by preeminence the first of the nine chief magistrates
rufol	a phenol derivative of anthracene obtained as a white crystalline substance which on oxidation produces a red dyestuff related to anthraquinone
decane	a liquid hydrocarbon ch of the paraffin series including several isomeric modifications
gabionage	the part of a fortification built of gabions
jeterus	a yellowness of the parts of plants which are normally green yellows
omphalopsychite	a name of the hesychasts from their habit of gazing upon the navel
huller	one who or that which hulls especially an agricultural machine for removing the hulls from grain a hulling machine
oxyquinoline	hydroxy quinoline a phenol derivative of quinoline  called also carbostyril
blore	the act of blowing a roaring wind a blast
swamp	wet spongy land soft low ground saturated with water but not usually covered with it marshy ground away from the seashore
shoer	one who fits shoes to the feet one who furnishes or puts on shoes as a shoer of horses
composer	one who composes an author specifically an author of a piece of music
trisyllable	a word consisting of three syllables only as avenger
mosasaurian	one of an extinct order of reptiles including mosasaurus and allied genera see mosasauria
hydrosoma	all the zooids of a hydroid colony collectively including the nutritive and reproductive zooids and often other kinds
skin	the external membranous integument of an animal
hospitableness	the quality of being hospitable hospitality
letheon	sulphuric ether used as an anaesthetic agent
davit	a spar formerly used on board of ships as a crane to hoist the flukes of the anchor to the top of the bow without injuring the sides of the ship  called also the fish davit
pulkha	a laplanders traveling sledge see sledge
bankrupt	a trader who secretes himself or does certain other acts tending to defraud his creditors
disimprovement	reduction from a better to a worse state as disimprovement of the earth
lecture	the act of reading as the lecture of holy scripture
maronite	one of a body of nominal christians who speak the arabic language and reside on mount lebanon and in different parts of syria they take their name from one maron of the th century
barroom	a room containing a bar or counter at which liquors are sold
genealogist	one who traces genealogies or the descent of persons or families
perthite	a kind of feldspar consisting of a laminated intertexture of albite and orthoclase usually of different colors
lawm	a very fine linen or sometimes cotton fabric with a rather open texture lawn is used for the sleeves of a bishops official dress in the english church and figuratively stands for the office itself
stellionate	any fraud not distinguished by a more special name  chiefly applied to sales of the same property to two different persons or selling that for ones own which belongs to another etc
salicin	a glucoside found in the bark and leaves of several species of willow salix and poplar and extracted as a bitter white crystalline substance
boustrophedon	an ancient mode of writing in alternate directions one line from left to right and the next from right to left as fields are plowed as in early greek and hittite
hoppo	a collector of customs as at canton an overseer of commerce
suite	a retinue or company of attendants as of a distinguished personage as the suite of an ambassador see suit n
cyanophyll	a blue coloring matter supposed by some to be one of the component parts of chlorophyll
readjournment	the act of readjourning a second or repeated adjournment
individuity	separate existence individuality oneness
raveling	the act of untwisting or of disentangling
shotgun	a light smoothbored gun often doublebarreled especially designed for firing small shot at short range and killing small game
captainry	power or command over a certain district chieftainship
misdoing	a wrong done a fault or crime an offense as it was my misdoing
boom	a long pole or spar run out for the purpose of extending the bottom of a particular sail as the jib boom the studdingsail boom etc
brennage	a tribute which tenants paid to their lord in lieu of bran which they were obliged to furnish for his hounds
hypericum	a genus of plants generally with dotted leaves and yellow flowers  called also st johnswort
gonorrhoea	a contagious inflammatory disease of the genitourinary tract affecting especially the urethra and vagina and characterized by a mucopurulent discharge pain in urination and chordee clap
hatching	a mode of execution in engraving drawing and miniature painting in which shading is produced by lines crossing each other at angles more or less acute  called also crosshatching
peso	a spanish dollar also an argentine chilian colombian etc coin equal to from  cents to a dollar also a pound weight
velveting	the fine shag or nap of velvet a piece of velvet velvet goods
tarry	consisting of or covered with tar like tar
infeasibility	the state of being infeasible impracticability
splayfoot	a foot that is abnormally flattened and spread out flat foot
gallium	a rare metallic element found in certain zinc ores it is white hard and malleable resembling aluminium and remarcable for its low melting point  f c symbol ga atomic weight
trussing	the timbers etc which form a truss taken collectively
solarium	an apartment freely exposed to the sun anciently an apartment or inclosure on the roof of a house in modern times an apartment in a hospital used as a resort for convalescents
windlass	a winding and circuitous way a roundabout course a shift
illuminant	that which illuminates or affords light as gas and petroleum are illuminants
sensualization	the act of sensualizing or the state of being sensualized
crossette	a return in one of the corners of the architrave of a door or window  called also ancon ear elbow
flycatcher	one of numerous species of birds that feed upon insects which they take on the wing
coriander	an umbelliferous plant the coriandrum sativum the fruit or seeds of which have a strong smell and a spicy taste and in medicine are considered as stomachic and carminative
experientialism	the doctrine that experience either that ourselves or of others is the test or criterion of general knowledge  opposed to intuitionists
snowbroth	snow and water mixed or snow just melted very cold liquor
seizure	the act of seizing or the state of being seized sudden and violent grasp or gripe a taking into possession as the seizure of a thief a property a throne etc
rocambole	a name of allium scorodoprasum and a ascalonium two kinds of garlic the latter of which is also called shallot
auricula	a species of primula or primrose called also from the shape of its leaves bearsear
spree	a merry frolic especially a drinking frolic a carousal
turacou	any one of several species of plantain eaters of the genus turacus native of africa they are remarkable for the peculiar green and red pigments found in their feathers
shovelboard	a board on which a game is played by pushing or driving pieces of metal or money to reach certain marks also the game itself called also shuffleboard shoveboard shovegroat shovelpenny
pyuria	a morbid condition in which pus is discharged in the urine
logarithm	one of a class of auxiliary numbers devised by john napier of merchiston scotland  to abridge arithmetical calculations by the use of addition and subtraction in place of multiplication and division
galvanoscope	an instrument or apparatus for detecting the presence of electrical currents especially such as are of feeble intensity
maguari	a south american stork euxenara maguari having a forked tail
spouse	a man or woman engaged or joined in wedlock a married person husband or wife
nonjoinder	the omission of some person who ought to have been made a plaintiff or defendant in a suit or of some cause of action which ought to be joined
tael	a denomination of money in china worth nearly six shillings sterling or about a dollar and forty cents also a weight of one ounce and a third
disciplinableness	the quality of being improvable by discipline
tufthunting	the practice of seeking after and hanging on noblemen or persons of quality especially in english universities
fleshmonger	one who deals in flesh hence a pimp a procurer a pander
aceldama	the potters field said to have lain south of jerusalem purchased with the bribe which judas took for betraying his master and therefore called the field of blood fig a field of bloodshed
barometz	the woollyskinned rhizoma or rootstock of a fern dicksonia barometz which when specially prepared and inverted somewhat resembles a lamb  called also scythian lamb
sphagnum	a genus of mosses having white leaves slightly tinged with red or green and found growing in marshy places bog moss peat moss
infiniteness	the state or quality of being infinite infinity greatness immensity
constantia	a superior wine white and red from constantia in cape colony
cabinetwork	the art or occupation of working upon wooden furniture requiring nice workmanship also such furniture
enneandria	a linnaean class of plants having nine stamens
pianograph	a form of melodiograph applied to a piano
ronde	a kind of script in which the heavy strokes are nearly upright giving the characters when taken together a round look
spancel	a rope used for tying or hobbling the legs of a horse or cow
coshering	a feudal prerogative of the lord of the soil entitling him to lodging and food at his tenants house
shellbark	a species of hickory carya alba whose outer bark is loose and peeling a shagbark also its nut
theodolite	an instrument used especially in trigonometrical surveying for the accurate measurement of horizontal angles and also usually of vertical angles it is variously constructed
cooee	a peculiar whistling sound made by the australian aborigenes as a call or signal
forewit	a leader or wouldbe leader in matters of knowledge or taste
faultfinding	the act of finding fault or blaming  used derogatively also adj
menial	belonging to a retinue or train of servants performing servile office serving
wollastonite	a silicate of lime of a white to gray red or yellow color occurring generally in cleavable masses rarely in tabular crystals tabular spar
incredibility	the quality or state of being incredible incredibleness
papilla	any minute nipplelike projection as the papillae of the tongue
stereobate	the lower part or basement of a building or pedestal  used loosely for several different forms of basement
instep	the arched middle portion of the human foot next in front of the ankle joint
dittybag	a sailors small bag to hold thread needles tape etc  also called sailors housewife
irremobability	the quality or state of being irremovable immovableness
anabasis	a journey or expedition up from the coast like that of the younger cyrus into central asia described by xenophon in his work called the anabasis
spirograph	an instrument for recording the respiratory movements as the sphygmograph does those of the pulse
parapet	a low wall especially one serving to protect the edge of a platform roof bridge or the like
integrator	that which integrates esp an instrument by means of which the area of a figure can be measured directly or its moment of inertia or statical moment etc be determined
antedate	prior date a date antecedent to another which is the actual date
navus	a spot or mark on the skin of children when born a birthmark  usually applied to vascular tumors i e those consisting mainly of blood vessels as dilated arteries veins or capillaries
urachus	a cord or band of fibrous tissue extending from the bladder to the umbilicus
paradise	the garden of eden in which adam and eve were placed after their creation
harebell	a small slender branching plant campanula rotundifolia having blue bellshaped flowers also scilla nutans which has similar flowers  called also bluebell
cosmometry	the art of measuring the world or the universe
bran	the broken coat of the seed of wheat rye or other cereal grain separated from the flour or meal by sifting or bolting the coarse chaffy part of ground grain
japan	work varnished and figured in the japanese manner also the varnish or lacquer used in japanning
baby	an infant or young child of either sex a babe
dabster	one who is skilled a master of his business a proficient an adept
lithocarp	fossil fruit a fruit petrified a carpolite
stylography	a mode of writing or tracing lines by means of a style on cards or tablets
livre	a french money of account afterward a silver coin equal to  sous it is not now in use having been superseded by the franc
separatism	the character or act of a separatist disposition to withdraw from a church the practice of so withdrawing
festivity	the condition of being festive social joy or exhilaration of spirits at an entertaintment joyfulness gayety
exemplar	a model original or pattern to be copied or imitated a specimen sometimes an ideal model or type as that which an artist conceives
brahmin	a person of the highest or sacerdotal caste among the hindoos
disinfectant	that which disinfects an agent for removing the causes of infection as chlorine
depth	the quality of being deep deepness perpendicular measurement downward from the surface or horizontal measurement backward from the front as the depth of a river the depth of a body of troops
infiltration	the act or process of infiltrating as if water into a porous substance or of a fluid into the cells of an organ or part of the body
prelacy	the office or dignity of a prelate church government by prelates
becket	a small grommet or a ring or loop of rope  metal for holding things in position as spars ropes etc also a bracket a pocket or a handle made of rope
ross	the rough scaly matter on the surface of the bark of trees
marlin	the american great marbled godwit limosa fedoa applied also to the redbreasted godwit limosa haematica
seraphicism	the character quality or state of a seraph seraphicalness
absoluteness	the quality of being absolute independence of everything extraneous unlimitedness absolute power independent reality positiveness
phlox	a genus of american herbs having showy red white or purple flowers
bewitchery	the power of bewitching or fascinating bewitchment charm fascination
fronde	a political party in france during the minority of louis xiv who opposed the government and made war upon the court party
incuriosity	want of curiosity or interest inattentiveness indifference
minibus	a kind of light passenger vehicle carrying four persons
rigorist	one who is rigorous  sometimes applied to an extreme jansenist
noseband	that part of the headstall of a bridle which passes over a horses nose
outcrop	the coming out of a stratum to the surface of the ground
creatin	a white crystalline nitrogenous substance found abundantly in muscle tissue
octachord	an instrument of eight strings a system of eight tones
chalaza	the place on an ovule or seed where its outer coats cohere with each other and the nucleus
appointor	the person who selects the appointee see appointee
mineralogy	the science which treats of minerals and teaches how to describe distinguish and classify them
usager	one who has the use of anything in trust for another
pilgrim	a wayfarer a wanderer a traveler a stranger
bushfighting	fighting in the bush or from behind bushes trees or thickets
chronopher	an instrument signaling the correct time to distant points by electricity
witling	a person who has little wit or understanding a pretender to wit or smartness
trapper	one who traps animals one who makes a business of trapping animals for their furs
devotee	one who is wholly devoted esp one given wholly to religion one who is superstitiously given to religious duties and ceremonies a bigot
tartarine	potassium carbonate obtained by the incineration of tartar
measurer	one who measures one whose occupation or duty is to measure commondities in market
infancy	the state or period of being an infant the first part of life early childhood
derrick	a mast spar or tall frame supported at the top by stays or guys with suitable tackle for hoisting heavy weights as stones in building
aisle	a lateral division of a building separated from the middle part called the nave by a row of columns or piers which support the roof or an upper wall containing windows called the clearstory wall
surplice	a white garment worn over another dress by the clergy of the roman catholic episcopal and certain other churches in some of their ministrations
stiletto	a kind of dagger with a slender rounded and pointed blade
readability	the state of being readable readableness
townsfolk	the people of a town especially the inhabitants of a city in distinction from country people townspeople
indobriton	a person born in india of mixed indian and british blood a halfcaste
phalangist	any arboreal marsupial of the genus phalangista the vulpine phalangist p vulpina is the largest species the full grown male being about two and a half feet long it has a large bushy tail
tache	something used for taking hold or holding a catch a loop a button
ironwort	an herb of the mint family sideritis supposed to heal sword cuts also a species of galeopsis
bevelment	the replacement of an edge by two similar planes equally inclined to the including faces or adjacent planes
ordonnance	the disposition of the parts of any composition with regard to one another and the whole
predecessor	one who precedes one who has preceded another in any state position office etc one whom another follows or comes after in any office or position
pollicitation	a voluntary engagement or a paper containing it a promise
convolution	the act of rolling anything upon itself or one thing upon another a winding motion
nonappearance	default of apperance as in court to prosecute or defend failure to appear
perispomenon	a word which has the circumflex accent on the last syllable
hamite	a fossil cephalopod of the genus hamites related to the ammonites but having the last whorl bent into a hooklike form
crucible	a vessel or melting pot composed of some very refractory substance as clay graphite platinum and used for melting and calcining substances which require a strong degree of heat as metals ores etc
fengite	a kind of marble or alabaster sometimes used for windows on account of its transparency
neuroskeleton	the deepseated parts of the vertebrate skeleton which are relation with the nervous axis and locomation
pinedrops	a reddish herb pterospora andromedea of the united states found parasitic on the roots of pine trees
buckle	to fasten or confine with a buckle or buckles as to buckle a harness
denominator	one who or that which gives a name origin or source of a name
oogonium	a special cell in certain cryptogamous plants containing oospheres as in the rockweeds fucus and the orders vaucherieae and peronosporeae
parodist	one who writes a parody one who parodies
reimportation	the act of reimporting also that which is reimported
adoptionist	one of a sect which maintained that christ was the son of god not by nature but by adoption
flesh	the aggregate of the muscles fat and other tissues which cover the framework of bones in man and other animals especially the muscles
defectionist	one who advocates or encourages defection
endosperm	the albumen of a seed  limited by recent writers to that formed within the embryo sac
rubidine	a nitrogenous base homologous with pyridine obtained from coal tar as an oily liquid chn also any one of the group od metameric compounds of which rubidine is the type
inculcation	a teaching and impressing by frequent repetitions
plantocracy	government by planters planters collectively
crossexaminer	one who crossexamines or conducts a crosseexamination
saur	soil dirt dirty water urine from a cowhouse
bowenite	a hard compact variety of serpentine found in rhode island it is of a light green color and resembles jade
sorbonist	a doctor of the sorbonne or theological college in the university of paris founded by robert de sorbon a d  it was suppressed in the revolution of
quadroon	the offspring of a mulatto and a white person a person quarterblooded
astarte	a genus of bivalve mollusks common on the coasts of america and europe
foxearth	a hole in the earth to which a fox resorts to hide himself
parcener	a coheir or one of two or more persons to whom an estate of inheritance descends jointly and by whom it is held as one estate
beeswing	the second crust formed in port and some other wines after long keeping it consists of pure shining scales of tartar supposed to resemble the wing of a bee
communion	the act of sharing community participation
mosque	a mohammedan church or place of religious worship
lactodensimeter	a form of hydrometer specially graduated for finding the density of milk and thus discovering whether it has been mixed with water or some of the cream has been removed
graphics	the art or the science of drawing esp of drawing according to mathematical rules as in perspective projection and the like
chine	a chink or cleft a narrow and deep ravine as shanklin chine in the isle of wight a quarter of a mile long and  feet deep
indolence	freedom from that which pains or harasses as toil care grief etc
tellureted	combined or impregnated with tellurium tellurized
urinometer	a small hydrometer for determining the specific gravity of urine
vishnu	a divinity of the modern hindu trimurti or trinity he is regarded as the preserver while brahma is the creator and siva the destroyer of the creation
ambitus	the exterior edge or border of a thing as the border of a leaf or the outline of a bivalve shell
marriageability	the quality or state of being marriageable
prolegomenon	a preliminary remark or observation an introductory discourse prefixed to a book or treatise
anther	that part of the stamen containing the pollen or fertilizing dust which when mature is emitted for the impregnation of the ovary
melton	a kind of stout woolen cloth with unfinished face and without raised nap a commoner variety has a cotton warp
nerve	one of the whitish and elastic bundles of fibers with the accompanying tissues which transmit nervous impulses between nerve centers and various parts of the animal body
strass	a brilliant glass used in the manufacture of artificial paste gems which consists essentially of a complex borosilicate of lead and potassium cf glass
herb	a plant whose stem does not become woody and permanent but dies at least down to the ground after flowering
telephony	the art or process of reproducing sounds at a distance as with the telephone
stela	a small column or pillar used as a monument milestone etc
mastodyny	pain occuring in the mamma or female breast  a form of neuralgia
barrulet	a diminutive of the bar having one fourth its width
efficacious	possessing the quality of being effective productive of or powerful to produce the effect intended as an efficacious law
odin	the supreme deity of the scandinavians  the same as woden of the german tribes
damnability	the quality of being damnable damnableness
suwarrow	the giant cactus cereus giganteus  so named by the indians of arizona called also saguaro
grenadillo	a handsome tropical american wood much used for making flutes and other wind instruments  called also grenada cocos or cocus and red ebony
dissatisfaction	the state of being dissatisfied unsatisfied or discontented uneasiness proceeding from the want of gratification or from disappointed wishes and expectations
sunn	an east indian leguminous plant crotalaria juncea and its fiber which is also called sunn hemp
baudekin	the richest kind of stuff used in garments in the middle ages the web being gold and the woof silk with embroidery   made originally at bagdad
deal	a part or portion a share hence an indefinite quantity degree or extent degree or extent as a deal of time and trouble a deal of cold
koklass	any pheasant of the genus pucrasia the birds of this genus inhabit india and china and are distinguished by having a long central and two lateral crests on the head called also pucras
sprat	a small european herring clupea sprattus closely allied to the common herring and the pilchard  called also garvie the name is also applied to small herring of different kinds
conductivity	the quality or power of conducting or of receiving and transmitting as heat electricity etc as the conductivity of a nerve
niche	a cavity hollow or recess generally within the thickness of a wall for a statue bust or other erect ornament hence any similar position literal or figurative
diapason	the octave or interval which includes all the tones of the diatonic scale
deerberry	a shrub of the blueberry group vaccinium stamineum also its bitter greenish white berry  called also squaw huckleberry
abolitionist	a person who favors the abolition of any institution especially negro slavery
asarone	a crystallized substance resembling camphor obtained from the asarum europaeum  called also camphor of asarum
disgregation	the process of separation or the condition of being separate as of the molecules of a body
pigsney	a word of endearment for a girl or woman
anteflexion	a displacement forward of an organ esp the uterus in such manner that its axis is bent upon itself
bridestake	a stake or post set in the ground for guests at a wedding to dance round
percheron	one of a breed of draught horses originating in perche an old district of france  called also percheronnorman
heterocarpism	the power of producing two kinds of reproductive bodies as in amphicarpaea in which besides the usual pods there are others underground
daltonism	inability to perceive or distinguish certain colors esp red color blindness it has various forms and degrees so called from the chemist dalton who had this infirmity
quest	the act of seeking or looking after anything attempt to find or obtain search pursuit as to rove in quest of game of a lost child of property etc
radiation	the act of radiating or the state of being radiated emission and diffusion of rays of light beamy brightness
pronouncement	the act of pronouncing a declaration a formal announcement
flummery	a light kind of food formerly made of flour or meal a sort of pap
croupade	a leap in which the horse pulls up his hind legs toward his belly
homoiousian	one of the semiarians of the th century who held that the son was of like but not the same essence or substance with the father  opposed to homoousian
bugbear	something frightful as a specter anything imaginary that causes needless fright something used to excite needless fear also something really dangerous used to frighten children etc
amperometer	an instrument for measuring the strength of an electrical current in amperes
indispensableness	the state or quality of being indispensable or absolutely necessary
phyllome	a foliar part of a plant any organ homologous with a leaf or produced by metamorphosis of a leaf
pylon	a low tower having a truncated pyramidal form and flanking an ancient egyptian gateway
voluptuary	a voluptuous person one who makes his physical enjoyment his chief care one addicted to luxury and the gratification of sensual appetites
agrostology	that part of botany which treats of the grasses
dynamist	one who accounts for material phenomena by a theory of dynamics
insinuation	the act or process of insinuating a creeping winding or flowing in
structurist	one who forms structures a builder a constructor
continuance	a holding on or remaining in a particular state permanence as of condition habits abode etc perseverance constancy duration stay
stripling	a youth in the state of adolescence or just passing from boyhood to manhood a lad
gallon	a measure of capacity containing four quarts  used for the most part in liquid measure but sometimes in dry measure
cribbing	the act of inclosing or confining in a crib or in close quarters
petalite	a rare mineral occurring crystallized and in cleavable masses usually white or nearly so in color it is a silicate of aluminia and lithia
pantechnicon	a depository or place where all sorts of manufactured articles are collected for sale
eduction	the act of drawing out or bringing into view
heading	the act or state of one who or that which heads formation of a head
logographer	a chronicler one who writes history in a condensed manner with short simple sentences
nocake	indian corn parched and beaten to powder  used for food by the northern american indians
demurrage	the detention of a vessel by the freighter beyond the time allowed in her charter party for loading unloading or sailing
leucophane	a mineral of a greenish yellow color it is a silicate of glucina lime and soda with fluorine called also leucophanite
bisilicate	a salt of metasilicic acid  so called because the ratio of the oxygen of the silica to the oxygen of the base is as two to one the bisilicates include many of the most common and important minerals
substratum	that which is laid or spread under that which underlies something as a layer of earth lying under another specifically agric the subsoil
bulrush	a kind of large rush growing in wet land or in water
immigration	the act of immigrating the passing or coming into a country for the purpose of permanent residence
roundsman	a patrolman also a policeman who acts as an inspector over the rounds of the patrolmen
selfreliance	reliance on ones own powers or judgment selftrust
promptness	promptitude readiness quickness of decision or action
laird	a lord a landholder esp one who holds land directly of the crown
protococcus	a genus of minute unicellular algae including the red snow plant protococcus nivalis
tipcat	a game in which a small piece of wood pointed at both ends called a cat is tipped or struck with a stick or bat so as to fly into the air
butterfly	a general name for the numerous species of diurnal lepidoptera
subindex	a number or mark placed opposite the lower part of a letter or symbol to distinguish the symbol thus a b c xn have    and n as subindices
refraction	the act of refracting or the state of being refracted
dziggetai	the kiang a wild horse or wild ass of thibet asinus hemionus
prolusion	a trial before the principal performance a prelude hence an introductory essay or exercise
buceros	a genus of large perching birds the hornbills
cervelat	an ancient wind instrument resembling the bassoon in tone
swanmark	a mark of ownership cut on the bill or swan
pantography	a general description entire view of an object
transformism	the hypothesis or doctrine that living beings have originated by the modification of some other previously existing forms of living matter  opposed to abiogenesis
alienage	the state or legal condition of being an alien
electrothermancy	that branch of electrical science which treats of the effect of an electric current upon the temperature of a conductor or a part of a circuit composed of two different metals
backsaw	a saw as a tenon saw whose blade is stiffened by an added metallic back
boride	a binary compound of boron with a more positive or basic element or radical  formerly called boruret
abortion	the act of giving premature birth particularly the expulsion of the human fetus prematurely or before it is capable of sustaining life miscarriage
confluence	the act of flowing together the meeting or junction of two or more streams the place of meeting
butment	a buttress of an arch the supporter or that part which joins it to the upright pier
cordelier	a franciscan  so called in france from the girdle of knotted cord worn by all franciscans
sabella	a genus of tubicolous annelids having a circle of plumose gills around the head
circuiter	one who travels a circuit as a circuit judge
marrow	the tissue which fills the cavities of most bones the medulla in the larger cavities it is commonly very fatty but in the smaller cavities it is much less fatty and red or reddish in color
querele	a complaint to a court see audita querela
despite	malice malignity spite malicious anger contemptuous hate
banister	a stringed musical instrument having a head and neck like the guitar and its body like a tambourine it has five strings and is played with the fingers and hands
quart	the fourth part a quarter hence a region of the earth
defecator	that which cleanses or purifies esp an apparatus for removing the feculencies of juices and sirups
gradual	proceeding by steps or degrees advancing step by step as in ascent or descent or from one state to another regularly progressive slow as a gradual increase of knowledge a gradual decline
standstill	a standing without moving forward or backward a stop a state or rest
saintsimonianism	the principles doctrines or practice of the saintsimonians  called also saint simonism
mendicancy	the condition of being mendicant beggary begging
mannerist	one addicted to mannerism a person who in action bearing or treatment carries characteristic peculiarities to excess see citation under mannerism
frequent	often to be met with happening at short intervals often repeated or occurring as frequent visits
contemptibility	the quality of being contemptible contemptibleness
killock	a small anchor also a kind of anchor formed by a stone inclosed by pieces of wood fastened together
talk	to utter words esp to converse familiarly to speak as in familiar discourse when two or more persons interchange thoughts
mesocarp	the middle layer of a pericarp which consists of three distinct or dissimilar layers
vedantist	one versed in the doctrines of the vedantas
quintain	an object to be tilted at  called also quintel
dakir	a measure of certain commodities by number usually ten or twelve but sometimes twenty as a daker of hides consisted of ten skins a daker of gloves of ten pairs
patristics	that departnent of historical theology which treats of the lives and doctrines of the fathers of the church
invention	the act of finding out or inventing contrivance or construction of that which has not before existed as the invention of logarithms the invention of the art of printing
chalet	a herdsmans hut in the mountains of switzerland
peppergrass	any herb of the cruciferous genus lepidium especially the garden peppergrass or garden cress lepidium sativum  called also pepperwort all the species have a pungent flavor
xylenol	any one of six metameric phenol derivatives of xylene obtained as crystalline substances chchoh
courche	a square piece of linen used formerly by women instead of a cap a kerchief
yelper	an animal that yelps or makes a yelping noise
quarter	one of four equal parts into which anything is divided or is regarded as divided a fourth part or portion as a quarter of a dollar of a pound of a yard of an hour etc
downthrow	the sudden drop or depression of the strata of rocks on one side of a fault see throw n
congregationalist	one who belongs to a congregational church or society one who holds to congregationalism
pungency	the quality or state of being pungent or piercing keenness sharpness piquancy as the pungency of ammonia
gonozooid	a sexual zooid or medusoid bud of a hydroid a gonophore see hydroidea and illust of campanularian
calvary	the place where christ was crucified on a small hill outside of jerusalem
dementia	insanity madness esp that form which consists in weakness or total loss of thought and reason mental imbecility idiocy
kremlin	the citadel of a town or city especially the citadel of moscow a large inclosure which contains imperial palaces cathedrals churches an arsenal etc
germ	that which is to develop a new individual as the germ of a fetus of a plant or flower and the like the earliest form under which an organism appears
nagyagite	a mineral of blackish leadgray color and metallic luster generally of a foliated massive structure foliated tellurium it is a telluride of lead and gold
shinty	a scotch game resembling hockey also the club used in the game
succory	a plant of the genus cichorium see chicory
genappe	a worsted yarn or cord of peculiar smoothness used in the manufacture of braid fringe etc
esparcet	the common sainfoin onobrychis sativa an old world leguminous forage plant
september	the ninth month of the year containing thurty days
sheepskin	the skin of a sheep or leather prepared from it
rheumatism	a general disease characterized by painful often multiple local inflammations usually affecting the joints and muscles but also extending sometimes to the deeper organs as the heart
machinist	a constrictor of machines and engines one versed in the principles of machines
mooner	one who abstractedly wanders or gazes about as if moonstruck
spirit	air set in motion by breathing breath hence sometimes life itself
caret	a mark  used by writers and proof readers to indicate that something is interlined above or inserted in the margin which belongs in the place marked by the caret
ketine	one of a series of organic bases obtained by the reduction of certain isonitroso compounds of the ketones in general they are unstable oily substances having a pungent aromatic odor
triglyceride	a glyceride formed by the replacement of three hydrogen atoms in glycerin by acid radicals
keeler	one employed in managing a newcastle keel  called also keelman
gnatworm	the aquatic larva of a gnat  called also colloquially wiggler
diegesis	a narrative or history a recital or relation
thesaurus	a treasury or storehouse hence a repository especially of knowledge  often applied to a comprehensive work like a dictionary or cyclopedia
annat	a half yearss stipend over and above what is owing for the incumbency due to a ministers heirs after his decease
knotwort	a small herbaceous trailing plant of the genus illecebrum i verticillatum
pomace	the substance of apples or of similar fruit crushed by grinding
bluegown	one of a class of paupers or pensioners or licensed beggars in scotland to whim annually on the kings birthday were distributed certain alms including a blue gown a beadsman
exercise	the act of exercising a setting in action or practicing employment in the proper mode of activity exertion application use habitual activity occupation in general practice
chrysalis	the pupa state of certain insects esp of butterflies from which the perfect insect emerges see pupa and aurelia a
tank	a small indian dry measure averaging  grains in weight also a bombay weight of  grains for pearls
malingerer	in the army a soldier who feigns himself sick or who induces or protracts an illness in order to avoid doing his duty hence in general one who shirks his duty by pretending illness or inability
ferrocyanate	a salt of ferrocyanic acid a ferrocyanide
outpatient	a patient who is outside a hospital but receives medical aid from it
mycology	that branch of botanical science which relates to the musgrooms and other fungi
hydria	a water jar esp one with a large rounded body a small neck and three handles some of the most beautiful greek vases are of this form
indenting	indentation an impression like that made by a tooth
simonian	one of the followers of simon magus also an adherent of certain heretical sects in the early christian church
coetanean	a person coetaneous with another a contemporary
lancepesade	an assistant to a corporal a private performing the duties of a corporal  called also lance corporal
overaction	perormance to excess exaggerated or excessive action
stook	a small collection of sheaves set up in the field a shock in england twelve sheaves
elflock	hair matted or twisted into a knot as if by elves
violantin	a complex nitrogenous substance produced as a yellow crystalline substance and regarded as a complex derivative of barbituric acid
frogbit	a european plant hydrocharis morsusranae floating on still water and propagating itself by runners it has roundish leaves and small white flowers
hatting	the business of making hats also stuff for hats
merriness	the quality or state of being merry merriment mirth gayety with laughter
bricklayer	one whose occupation is to build with bricks
reciprocalness	the quality or condition of being reciprocal mutual return alternateness
wrongdoer	one who injures another or who does wrong
ecthoreum	the slender hollow thread of a nettling cell or cnida see nettling cell
heliopora	an east indian stony coral now known to belong to the alcyonaria  called also blue coral
polariscopy	the art or rocess of making observations with the polariscope
lemming	any one of several species of small arctic rodents of the genera myodes and cuniculus resembling the meadow mice in form they are found in both hemispheres
pantalet	one of the legs of the loose drawers worn by children and women particularly the lower part of such a garment coming below the knee often made in a separate piece  chiefly in the plural
kelp	the calcined ashes of seaweed  formerly much used in the manufacture of glass now used in the manufacture of iodine
rockweed	any coarse seaweed growing on seawashed rocks especially fucus
catchdrain	a ditch or drain along the side of a hill to catch the surface water also a ditch at the side of a canal to catch the surplus water
revocation	the act of calling back or the state of being recalled recall
calender	to press between rollers for the purpose of making smooth and glossy or wavy as woolen and silk stuffs linens paper etc
clinodiagonal	that diagonal or lateral axis in a monoclinic crystal which makes an oblique angle with the vertical axis see crystallization
fiddlestick	the bow strung with horsehair used in playing the fiddle a fiddle bow
salmis	a ragout of partly roasted game stewed with sauce wine bread and condiments suited to provoke appetite
cannibal	a human being that eats human flesh hence any that devours its own kind
steaminess	the quality or condition of being steamy vaporousness mistness
sophistication	the act of sophisticating adulteration as the sophistication of drugs
knoll	a little round hill a mound a small elevation of earth the top or crown of a hill
externe	an officer in attendance upon a hospital but not residing in it esp one who cares for the outpatients
stumpage	timber in standing trees  often sold without the land at a fixed price per tree or per stump the stumps being counted when the land is cleared
affiancer	one who makes a contract of marriage between two persons
storekeeper	a man in charge of stores or goods of any kind as a naval storekeeper
toparmor	a top railing supported by stanchions and equipped with netting
moro	a small abscess or tumor having a resemblance to a mulberry
spud	a sharp narrow spade usually with a long handle used by farmers for digging up largerooted weeds a similarly shaped implement used for various purposes
sobriety	habitual soberness or temperance as to the use of spirituous liquors as a man of sobriety
constriction	the act of constricting by means of some inherent power or by movement or change in the thing itself as distinguished from compression
lisbon	a sweet lightcolored species of wine produced in the province of estremadura and so called as being shipped from lisbon in portugal
polypide	one of the ordinary zooids of the bryozoa
cholecystotomy	the operation of making an opening in the gall bladder as for the removal of a gallstone
catholicism	the state or quality of being catholic or universal catholicity
iodal	an oily liquid clcho analogous to chloral and bromal
drome	the crab plover dromas ardeola a peculiar north african bird allied to the oyster catcher
hegemony	leadership preponderant influence or authority  usually applied to the relation of a government or state to its neighbors or confederates
inexplicability	the quality or state of being inexplicable
lampadist	one who gained the prize in the lampadrome
tucan	the mexican pocket gopher geomys mexicanus it resembles the common pocket gopher of the western united states but is larger called also tugan and tuza
cotqueanity	the condition character or conduct of a cotquean
sebesten	the mucilaginous drupaceous fruit of two east indian trees cordia myxa and c latifolia sometimes used medicinally in pectoral diseases
voltage	electric potential or potential difference expressed in volts
shiverspar	a variety of calcite so called from its slaty structure  called also slate spar
tablecloth	a cloth for covering a table especially one with which a table is covered before the dishes etc are set on for meals
termes	a genus of pseudoneuroptera including the white ants or termites see termite
catastasis	that part of a speech usually the exordium in which the orator sets forth the subject matter to be discussed
norwegium	a rare metallic element of doubtful identification said to occur in the coppernickel of norway
millwright	a mechanic whose occupation is to build mills or to set up their machinery
amorousness	the quality of being amorous or inclined to sexual love lovingness
contesseration	an assemblage a collection harmonious union
amovability	liability to be removed or dismissed from office
quantification	modification by a reference to quantity the introduction of the element of quantity
profusion	the act of one who is profuse a lavishing or pouring out without sting
nickeline	an alloy of nickel a variety of german silver
physalia	a genus of large oceanic siphonophora which includes the portuguese manofwar
tilefish	a large edible deepwater food fish lopholatilus chamaeleonticeps more or less thickly covered with large round yellow spots
hypocarpium	a fleshy enlargement of the receptacle or for the stem below the proper fruit as in the cashew see illust of cashew
corbeltable	a horizontal row of corbels with the panels or filling between them also less properly used to include the stringcourse on them
palatableness	the quality or state of being agreeable to the taste relish acceptableness
elutriation	the process of elutriating a decanting or racking off by means of water as finer particles from heavier
body	the material organized substance of an animal whether living or dead as distinguished from the spirit or vital principle the physical person
genitor	one who begets a generator an originator
piculet	any species of very small woodpeckers of the genus picumnus and allied genera their tail feathers are not stiff and sharp at the tips as in ordinary woodpeckers
lobefoot	a bird having lobate toes esp a phalarope
basigynium	the pedicel on which the ovary of certain flowers as the passion flower is seated a carpophore or thecaphore
hematosis	sanguification the conversion of chyle into blood
majolica	a kind of pottery with opaque glazing and showy which reached its greatest perfection in italy in the th century
canthoplasty	the operation of forming a new canthus when one has been destroyed by injury or disease
gnathastegite	one of a pair of broad plates developed from the outer maxillipeds of crabs and forming a cover for the other mouth organs
broth	liquid in which flesh and sometimes other substances as barley or rice has been boiled thin or simple soup
aurochloride	the trichloride of gold combination with the chloride of another metal forming a double chloride  called also chloraurate
bard	a professional poet and singer as among the ancient celts whose occupation was to compose and sing verses in honor of the heroic achievements of princes and brave men
centesimo	a copper coin of italy and spain equivalent to a centime
moonsail	a sail sometimes carried in light winds above a skysail
recipient	a receiver the person or thing that receives one to whom or that to which anything is given or communicated specifically the receiver of a still
osteodentine	a hard substance somewhat like bone which is sometimes deposited within the pulp cavity of teeth
grossness	the state or quality of being gross thickness corpulence coarseness shamefulness
dermopteran	an insect which has the anterior pair of wings coriaceous and does not use them in flight as the earwig
egyptologist	one skilled in the antiquities of egypt a student of egyptology
tumor	a morbid swelling prominence or growth on any part of the body especially a growth produced by deposition of new tissue a neoplasm
epode	the after song the part of a lyric ode which follows the strophe and antistrophe  the ancient ode being divided into strophe antistrophe and epode
outrage	to commit outrage upon to subject to outrage to treat with violence or excessive abuse
procession	the act of proceeding moving on advancing or issuing regular orderly or ceremonious progress continuous course
totality	the quality or state of being total as the totality of an eclipse
lepidodendron	a genus of fossil trees of the devonian and carboniferous ages having the exterior marked with scars mostly in quincunx order produced by the separation of the leafstalks
poorhouse	a dwelling for a number of paupers maintained at public expense an almshouse a workhouse
willowherb	a perennial herb epilobium spicatum with narrow willowlike leaves and showy rosepurple flowers the name is sometimes made to include other species of the same genus
nonplus	a state or condition which daffles reason or confounds judgment insuperable difficalty inability to proceed or decide puzzle quandary
quackery	the acts arts or boastful pretensions of a quack false pretensions to any art empiricism
countryside	a particular rural district a country neighborhood
excursionist	one who goes on an excursion or pleasure trip
battle	to join in battle to contend in fight as to battle over theories
tipping	a distinct articulation given in playing quick notes on the flute by striking the tongue against the roof of the mouth doubletonguing
emulation	the endeavor to equal or to excel another in qualities or actions an assiduous striving to equal or excel another rivalry
sonata	an extended composition for one or two instruments consisting usually of three or four movements as beethovens sonatas for the piano for the violin and piano etc
serolin	a peculiar fatty substance found in the blood probably a mixture of fats cholesterin etc
tocology	the science of obstetrics or midwifery that department of medicine which treats of parturition
abattis	a means of defense formed by felled trees the ends of whose branches are sharpened and directed outwards or against the enemy
diplomacy	the art and practice of conducting negotiations between nations particularly in securing treaties including the methods and forms usually employed
scissel	the clippings of metals made in various mechanical operations
jararaca	a poisonous serpent of brazil bothrops jararaca about eighteen inches long and of a dusky brownish color variegated with red and black spots
dime	a silver coin of the united states of the value of ten cents the tenth of a dollar
hyena	any carnivorous mammal of the family hyaenidae of which three living species are known they are large and strong but cowardly they feed chiefly on carrion and are nocturnal in their habits
melanorrhoea	an east indian genus of large trees melanorrha usitatissima is the lignumvitae of pegu and yelds a valuable black varnish
lodestone	a piece of magnetic iron ore possessing polarity like a magnetic needle see magnetite
geyserite	a loose hydrated form of silica a variety of opal deposited in concretionary cauliflowerlike masses around some hot springs and geysers
toadeater	a fawning obsequious parasite a mean sycophant a flatterer a toady
monesin	the acrid principle of monesia sometimes used as a medicine
titrate	to analyse or determine the strength of by means of standard solutions cf standardized solution under solution
currant	a small kind of seedless raisin imported from the levant chiefly from zante and cephalonia  used in cookery
corm	a solid bulbshaped root as of the crocus see bulb
systematology	the doctrine of or a treatise upon systems
binder	one who binds as a binder of sheaves one whose trade is to bind as a binder of books
heathenism	the religious system or rites of a heathen nation idolatry paganism
annulment	the act of annulling abolition invalidation
candlemas	the second day of february on which is celebrated the feast of the purification of the virgin mary  so called because the candles for the altar or other sacred uses are blessed on that day
whirlwind	a violent windstorm of limited extent as the tornado characterized by an inward spiral motion of the air with an upward current in the center a vortex of air it usually has a rapid progressive motion
don	sir mr signior  a title in spain formerly given to noblemen and gentlemen only but now common to all classes
pachydactyl	a bird or other animal having thick toes
onager	a military engine acting like a sling which threw stones from a bag or wooden bucket and was operated by machinery
kiosk	a turkish open summer house or pavilion supported by pillars
layman	one of the people in distinction from the clergy one of the laity sometimes a man not belonging to some particular profession in distinction from those who do
helcoplasty	the act or process of repairing lesions made by ulcers especially by a plastic operation
ichthulin	a substance from the yolk of salmons egg
ignominy	public disgrace or dishonor reproach infamy
duumvirate	the union of two men in the same office or the office dignity or government of two men thus associated as in ancient rome
leadhillite	a mineral of a yellowish or greenish white color consisting of the sulphate and carbonate of lead  so called from having been first found at leadhills scotland
publican	a farmer of the taxes and public revenues hence a collector of toll or tribute the inferior officers of this class were often oppressive in their exactions and were regarded with great detestation
heptone	a liquid hydrocarbon ch of the valylene series
scotoscope	an instrument that discloses objects in the dark or in a faint light
pinnace	a small vessel propelled by sails or oars formerly employed as a tender or for coast defence  called originally spynace or spyne
taurocholate	a salt of taurocholic acid as sodium taurocholate which occurs in human bile
offskip	that part of a landscape which recedes from the spectator into distance
provision	the act of providing or making previous preparation
confiture	composition preparation as of a drug or confection a sweetmeat
saccharone	a white crystalline substance cho obtained by the oxidation of saccharin and regarded as the lactone of saccharonic acid
divaricator	one of the muscles which open the shell of brachiopods a cardinal muscle see illust of brachiopoda
pataca	the spanish dollar  called also patacoon
wording	the act or manner of expressing in words style of expression phrasing
cartoon	a design or study drawn of the full size to serve as a model for transferring or copying  used in the making of mosaics tapestries fresco pantings and the like as the cartoons of raphael
lacuna	a small opening a small pit or depression a small blank space a gap or vacancy a hiatus
dolt	a heavy stupid fellow a blockhead a numskull an ignoramus a dunce a dullard
soulili	a longtailed crested javan monkey semnopithecus mitratus the head the crest and the upper surface of the tail are black
lactimide	a white crystalline substance obtained as an anhydride of alanine and regarded as an imido derivative of lactic acid
brookweed	a small whiteflowered herb samolus valerandi found usually in wet places water pimpernel
equation	a making equal equal division equality equilibrium
lemonade	a beverage consisting of lemon juice mixed with water and sweetened
capitalist	one who has capital one who has money for investment or money invested esp a person of large property which is employed in business
probabilist	one who maintains that certainty is impossible and that probability alone is to govern our faith and actions
pax	the kiss of peace also the embrace in the sanctuary now substituted for it at high mass in roman catholic churches
belial	an evil spirit a wicked and unprincipled person the personification of evil
corruptionist	one who corrupts or who upholds corruption
tutelage	the act of guarding or protecting guardianship protection as the kings right of seigniory and tutelage
prothorax	the first or anterior segment of the thorax in insects see illusts of butterfly and coleoptera
phenicine	a purple powder precipitated when a sulphuric solution of indigo is diluted with water
courtesy	politeness civility urbanity courtliness
bobcherry	a play among children in which a cherry hung so as to bob against the mouth is to be caught with the teeth
somnolism	the somnolent state induced by animal magnetism
precoracoid	the anterior part of the coracoid often closely united with the clavicle in the shoulder girdle of many reptiles and amphibians
snot	mucus secreted in or discharged from the nose
clearance	the act of clearing as to make a thorough clearance
stycerin	a triacid alcohol related to glycerin and obtained from certain styryl derivatives as a yellow gummy amorphous substance  called also phenyl glycerin
aerophyte	a plant growing entirely in the air and receiving its nourishment from it an air plant or epiphyte
disarrangement	the act of disarranging or the state of being disarranged confusion disorder
fescue	a straw wire stick etc used chiefly to point out letters to children when learning to read
telluride	a compound of tellurium with a more positive element or radical  formerly called telluret
nepa	a genus of aquatic hemipterus insects the species feed upon other insects and are noted for their voracity  called also scorpion bug and water scorpion
sclerobase	the calcareous or hornlike coral forming the central stem or axis of most compound alcyonarians  called also foot secretion see illust under gorgoniacea and coenenchyma
foreskin	the fold of skin which covers the glans of the penis the prepuce
clockwork	the machinery of a clock or machinery resembling that of a clock machinery which produces regularity of movement
itacolumite	a laminated granular siliceous rocks often occurring in regions where the diamond is found
rheometry	the measurement of the force or intensity of currents
valeritrine	a base chn produced together with valeridine which it resembles
homoeomeria	the state or quality of being homogeneous in elements or first principles likeness or identity of parts
aerometry	the science of measuring the air including the doctrine of its pressure elasticity rarefaction and condensation pneumatics
earldom	the jurisdiction of an earl the territorial possessions of an earl
reception	the act of receiving receipt admission as the reception of food into the stomach the reception of a letter the reception of sensation or ideas reception of evidence
guillemot	one of several northern sea birds allied to the auks they have short legs placed far back and are expert divers and swimmers
whirlabout	something that whirls or turns about in a rapid manner a whirligig
aorta	the great artery which carries the blood from the heart to all parts of the body except the lungs the main trunk of the arterial system
nopal	a cactaceous plant nopalea cochinellifera originally mexican on which the cochineal insect feeds and from which it is collected the name is sometimes given to other species of cactaceae
design	to draw preliminary outline or main features of to sketch for a pattern or model to delineate to trace out to draw
frostwork	the figurework often fantastic and delicate which moisture sometimes forms in freezing as upon a window pane or a flagstone
foreordination	previous ordination or appointment predetermination predestination
anachorism	an error in regard to the place of an event or a thing a referring something to a wrong place
azarole	the neapolitan medlar crataegus azarolus a shrub of southern europe also its fruit
vaulting	the act of constructing vaults a vaulted construction
sarcophile	a flesheating animal especially any one of the carnivorous marsupials
buckeye	a name given to several american trees and shrubs of the same genus aesculus as the horse chestnut
beurre	a beurre or buttery pear one with the meat soft and melting  used with a distinguishing word as beurre danjou beurre clairgeau
pathology	the science which treats of diseases their nature causes progress symptoms etc
tent	a kind of wine of a deep red color chiefly from galicia or malaga in spain  called also tent wine and tinta
patchery	botchery covering of defects bungling hypocrisy
amphiuma	a genus of amphibians inhabiting the southern united states having a serpentlike form but with four minute limbs and two persistent gill openings the congo snake
sumpitan	a kind of blowgun for discharging arrows  used by the savages of borneo and adjacent islands
bushranger	one who roams or hides among the bushes especially in australia an escaped criminal living in the bush
straightness	the quality condition or state of being straight as the straightness of a path
disfavor	want of favor of favorable regard disesteem disregard
disposure	the act of disposing power to dispose of disposal direction
nonacquaintance	want of acquaintance the state of being unacquainted
papoose	a babe or young child of indian parentage in north america
philosophy	literally the love of including the search after wisdom in actual usage the knowledge of phenomena as explained by and resolved into causes and reasons powers and laws
undercroft	a subterranean room of any kind esp one under a church see crypt or one used as a chapel or for any sacred purpose
atmolysis	the act or process of separating mingled gases of unequal diffusibility by transmission through porous substances
misthought	erroneous thought mistaken opinion error
purpure	purple  represented in engraving by diagonal lines declining from the right top to the left base of the escutcheon or from sinister chief to dexter base
hellgramite	the aquatic larva of a large american winged insect corydalus cornutus much used a fish bait by anglers the dobson it belongs to the neuroptera
tritheism	the opinion or doctrine that the father son and holy spirit are three distinct gods
epanalepsis	a figure by which the same word or clause is repeated after intervening matter
enormity	the state or quality of exceeding a measure or rule or of being immoderate monstrous or outrageous
kale	a variety of cabbage in which the leaves do not form a head being nearly the original or wild form of the species
depopulation	the act of depopulating or condition of being depopulated destruction or explusion of inhabitants
nonnecessity	absence of necessity the quality or state of being unnecessary
desideratum	anything desired that of which the lack is felt a want generally felt and acknowledge
chrysocolla	a hydrous silicate of copper occurring massive of a blue or greenish blue color
avesta	the zoroastrian scriptures see zendavesta
mountebankism	the practices of a mountebank mountebankery
machiavelianism	the supposed principles of machiavel or practice in conformity to them political artifice intended to favor arbitrary power
sunglow	a rosy flush in the sky seen after sunset
psalterium	the third stomach of ruminants see manyplies
jove	the chief divinity of the ancient romans jupiter
cupbearer	one whose office it is to fill and hand the cups at an entertainment
corncutter	a machine for cutting up stalks of corn for food of cattle
billon	an alloy of gold and silver with a large proportion of copper or other base metal used in coinage
siamang	a gibbon hylobates syndactylus native of sumatra it has the second and third toes partially united by a web
cinnamone	a yellow crystalline substance chchco the ketone of cinnamic acid
rescission	the act of rescinding abrogating annulling or vacating as the rescission of a law decree or judgment
yamp	an umbelliferous plant carum gairdneri also its small fleshy roots which are eaten by the indians from idaho to california
multiloquence	quality of being multiloquent use of many words talkativeness
costumer	one who makes or deals in costumes as for theaters fancy balls etc
propithecus	a genus including the longtailed or diadem indris see indris
antanagoge	a figure which consists in answering the charge of an adversary by a counter charge
cygnus	a constellation of the northern hemisphere east of or following lyra the swan
althea	a genus of plants of the mallow family it includes the officinal marsh mallow and the garden hollyhocks
mowing	the act of one who or the operation of that which mows
raillery	pleasantry or slight satire banter jesting language satirical merriment
chrestomathy	a selection of passages with notes etc to be used in acquiring a language as a hebrew chrestomathy
navew	a kind of small turnip a variety of brassica campestris see brassica
cyprus	a thin transparent stuff the same as or corresponding to crape it was either white or black the latter being most common and used for mourning
peanism	the song or shout of praise of battle or of triumph
huchen	a large salmon salmo  salvelinus hucho inhabiting the danube  called also huso and bull trout
digression	the act of digressing or deviating esp from the main subject of a discourse hence a part of a discourse deviating from its main design or subject
tomb	a pit in which the dead body of a human being is deposited a grave a sepulcher
priestery	priests collectively the priesthood  so called in contempt
yare	ready dexterous eager lively quick to move
vouchsafement	the act of vouchsafing or that which is vouchsafed a gift or grant in condescension
vari	the ringtailed lemur lemur catta of madagascar its long tail is annulated with black and white
dais	the high or principal table at the end of a hall at which the chief guests were seated also the chief seat at the high table
declension	the act or the state of declining declination descent slope
restringency	quality or state of being restringent astringency
teapoy	an ornamental stand usually with three legs having caddies for holding tea
wrangler	an angry disputant one who disputes with heat or peevishness
induline	any one of a large series of aniline dyes colored blue or violet and represented by aniline violet
tuna	the opuntia tuna see prickly pear under prickly
reinvestment	the act of investing anew a second or repeated investment
daymare	a kind of incubus which occurs during wakefulness attended by the peculiar pressure on the chest which characterizes nightmare
whimsicalness	the quality or state of being whimsical freakishness whimsical disposition
petiolule	a small petiole or the petiole of a leaflet
typhoon	a violent whirlwind specifically a violent whirlwind occurring in the chinese seas
curmudgeon	an avaricious grasping fellow a miser a niggard a churl
remissibility	the state or quality of being remissible
woolder	a stick used to tighten the rope in woolding
chrysology	that branch of political economy which relates to the production of wealth
mouthpiece	the part of a musical or other instrument to which the mouth is applied in using it as the mouthpiece of a bugle or of a tobacco pipe
hippurite	a fossil bivalve mollusk of the genus hippurites of many species having a conical cupshaped under valve with a flattish upper valve or lid hippurites are found only in the cretaceous rocks
species	visible or sensible presentation appearance a sensible percept received by the imagination an image
nonego	the union of being and relation as distinguished from and contrasted with the ego see ego
obscurity	the quality or state of being obscure darkness privacy inconspicuousness unintelligibleness uncertainty
platymeter	an apparatus for measuring the capacity of condensers or the inductive capacity of dielectrics
mispersuasion	a false persuasion wrong notion or opinion
range	to set in a row or in rows to place in a regular line or lines or in ranks to dispose in the proper order to rank as to range soldiers in line
conchologist	one who studies or is versed in conchology
ankylosis	stiffness or fixation of a joint formation of a stiff joint
bought	a flexure a bend a twist a turn a coil as in a rope as the boughts of a serpent
bijou	a trinket a jewel  a word applied to anything small and of elegant workmanship
pericranium	the periosteum which covers the cranium externally the region around the cranium
tapeline	a painted tape marked with linear dimensions as inches feet etc and often inclosed in a case  used for measuring
seton	a few silk threads or horsehairs or a strip of linen or the like introduced beneath the skin by a knife or needle so as to form an issue also the issue so formed
marigold	a name for several plants with golden yellow blossoms especially the calendula officinalis see calendula and the cultivated species of tagetes
organogenesis	the origin and development of organs in animals and plants
anemograph	an instrument for measuring and recording the direction and force of the wind
narrowing	the act of contracting or of making or becoming less in breadth or extent
impracticability	the state or quality of being impracticable infeasibility
plasmogen	the important living portion of protoplasm considered a chemical substance of the highest elaboration germ plasm and idioplasm are forms of plasmogen
spadix	a fleshy spike of flowers usually inclosed in a leaf called a spathe
verjuice	the sour juice of crab apples of green or unripe grapes apples etc also an acid liquor made from such juice
compliment	an expression by word or act of approbation regard confidence civility or admiration a flattering speech or attention a ceremonious greeting as to send ones compliments to a friend
apomorphine	a crystalline alkaloid obtained from morphia it is a powerful emetic
beacon	a signal fire to notify of the approach of an enemy or to give any notice commonly of warning
subway	an underground way or gallery especially a passage under a street in which water mains gas mains telegraph wires etc are conducted
polyphony	multiplicity of sounds as in the reverberations of an echo
monitor	one who admonishes one who warns of faults informs of duty or gives advice and instruction by way of reproof or caution
relax	to make lax or loose to make less close firm rigid tense or the like to slacken to loosen to open as to relax a rope or cord to relax the muscles or sinews
douar	a village composed of arab tents arranged in streets
sacristan	an officer of the church who has the care of the utensils or movables and of the church in general a sexton
ruff	a game similar to whist and the predecessor of it
schmelze	a kind of glass of a red or ruby color made in bohemia
dioptre	a unit employed by oculists in numbering glasses according to the metric system a refractive power equal to that of a glass whose principal focal distance is one meter
impanelment	the act or process of impaneling or the state of being impaneled
chondrodite	a fluosilicate of magnesia and iron yellow to red in color often occurring in granular form in a crystalline limestone
telemeter	an instrument used for measuring the distance of an object from an observer as a telescope with a micrometer for measuring the apparent diameter of an object whose real dimensions are known
opportunity	fit or convenient time a time or place favorable for executing a purpose a suitable combination of conditions suitable occasion chance
feast	a festival a holiday a solemn or more commonly a joyous anniversary
jot	an iota a point a tittle the smallest particle cf bit n
ducat	a coin either of gold or silver of several countries in europe originally one struck in the dominions of a duke
meddler	one who meddles one who interferes or busies himself with things in which he has no concern an officious person a busybody
ommateum	a compound eye as of insects and crustaceans
liana	a luxuriant woody plant climbing high trees and having ropelike stems the grapevine often has the habit of a liane lianes are abundant in the forests of the amazon region
sandre	a russian fish lucioperca sandre which yields a valuable oil called sandre oil used in the preparation of caviare
official	of or pertaining to an office or public trust as official duties or routine
concettism	the use of concetti or affected conceits
scutage	shield money commutation of service for a sum of money see escuage
adulation	servile flattery praise in excess or beyond what is merited
ontology	that department of the science of metaphysics which investigates and explains the nature and essential properties and relations of all beings as such or the principles and causes of being
chooser	one who chooses one who has the power or right of choosing an elector
somatist	one who admits the existence of material beings only a materialist
fluosilicate	a double fluoride of silicon and some other usually basic element or radical regarded as a salt of fluosilicic acid  called also silicofluoride
distance	the space between two objects the length of a line especially the shortest line joining two points or things that are separate measure of separation in place
tracheotomy	the operation of making an opening into the windpipe
catgut	a cord of great toughness made from the intestines of animals esp of sheep used for strings of musical instruments etc
limber	the shafts or thills of a wagon or carriage
dephlegmator	an instrument or apparatus in which water is separated by evaporation or distillation the part of a distilling apparatus in which the separation of the vapors is effected
backhouse	a building behind the main building specifically a privy a necessary
trangram	something intricately contrived a contrived a puzzle